15 60 30
11111111111111
01111111111111
00111111111111
00011111111111
00001111111111
00000111111111
00000011111111
00000001111111
00000000111111
00000000011111
00000000001111
00000000000111
00000000000011
06066600000001